NO 
SO images/mac.png
WE images/cheeseburger.png
EA images/bur.png

F 255,255,0
C 255,0,0

1111111111111111111111111
1000000000000000000000001
1000000000000000000000001
1000000000000000000000001
100000000000W000000000001
1000000000000000000000001
1000000000000000000000001
1111111111111111111111111