111111111111111111
1E0001010010000101
100100011010000101
110000000100000101
100100011000000101
110000000000000001
111111111111111111