NO images/promo.png
SO images/singe.png
WE images/doc.png
EA images/bran.png

F 102,0,102
C 56,56,56

1111111111111111111111111
1000000000000000000000001
1000100000000000000100001
101000001000W000100000001
1000010000001000000100001
1010000010000000100001001
1000000000000000000000001
1111111111111111111111111