NO images/colorstone.png
SO images/mossy.png
WE images/eagle.png
EA images/redbrick.png

F 221,12,12
C 12,12,12

111111111111111111111111111
100000000000000000000000001
100010001110000001111100001
100000110110000010001100001
100001100110000000011000001
100011111111100000110000001
100000000110000011000000001
10000000011000011111100N001
100000000000000000000000001
111111111111111111111111111
