NO images/colorstone.png
SO images/mossy.png
WE images/eagle.png
EA images/redbrick.png

F 112,112,112
C 56,56,56

111111111111111111111111111111111111111111111111111111111111111111111111111111111111
100000000000000000000000000000000000000000000000000000000000000110000000000000000001
100000000000000000100000000000000001110000000000000000000001000000000000000000000001
100000000000000100000000000000000000000000111110000000000001000000000000000000000001
100000100000010000001000001010001010101000000000100000000000000000000000010000000001
100000000000000000000000000000000000001000000000010000000000000000000000010000000001
111111111111111111111100000000000000000000000000000000000000000000011111111111111111
111111111111111111111100000000000000000000000000000000000000000000011111111111111111
111111111111111111111100000000000011111111111111111111111111111111111111111111111111
100000000000000000000000000000000000000000000000000000000000000000000000000000000001
100000000000000000000000000000000000000000000000000000000000000000000000000000000001
100000000000000000000000000000000000000000000000000000000000000000000000000000000001
10000000000000000000000000000000000000N                            00000000000000001
100000000000000000000000000000000000000000000000000000000000000000000000000000000001
100000000000000000000000000000000000000000000000000000000000000000000000000000000001
100000000000000000000000000000000000000000000000000000000000000000000000000000000001
100000000000000000000000000000000000000000000000000000000000000000000000000000000001
100000000000000000000000000000011111000000000000000000000001111000000000000000000011
100000000000000000000000000000011111000000000000000000000001111000000000000000000001
100000000000000000000000000000000000000000000000000000000000000000000000000000000001
111111111111111111111100000000000011111111111111111111111111111111111111111111111111
111111111111111111111100000000000011111111111111111111111111111111111111111111111111
111111111111111111111100000000000011111111111111111111111111111111111111111111111111
100000000000000000000000000000000000000000000000000000000000000000000000000000000001
100000000000000000000000000000000000000000000000000000000000000000000000000000000001
111111111111111111111111111111111111111111111111111111111111111111111111111111111111