NO images/eagle.png
SO images/colorstone.png
WE images/redbrick.png
EA images/mossy.png

F 112,112,112
C 56,56,56

    111111111111111111111111111
    000000000011000000000000111
1111111011000001110000000000001
100100000N00000000000000111111111
111111111011000001110000000000001
100000000011000001110111111111111
11110111111111011100000010001
11110111111111011101010010001
11000000110101011100000010001
100000000    0001100000010001
10000000000000001101010010001
1100000111010101111101111000111
11110111 1110100 101111010001
11111111 1111111 111111111111