NO images/singe.png
SO images/doc.png
WE images/promo.png
EA images/bran.png

F 102,0,102
C 56,56,56

1111111111111111111111111
1000000000000000000000001
100000000000W000000000001
1000000000000000000000001
1000000000000000000000001
1000000000000000000000001
1000000000000000000000001
1111111111111111111111111