NO images/colorstone.png
SO images/mossy.png
WE images/eagle.png
EA images/redbrick.png

F 112,112,112
C 56,56,56

    111111111111111111111111111
    100000000011000000000000001
1111111011000001110000N00000001
100100000000000000000000111111111
111111111011000001110000000000001
100000000011000001110111111111111
111101111111110111000000100000001       
111101111111110111010100001111111
11111111111111111111111111111
11111111111111111111111111111
11000000110101011100000010001       111111111
 00000000    0001100000010001       100000001
10000000000000001101010010001       111111111
1100000111010101111101111000111
11110111 1110100 1011110 10001
11111111 1111111 1111111111111