1111111111
1000000001
1011101101
    101
1010000101
1010110101
1000010001
1111111111